....................
.#...........#......
..#..........#......
..@@@@.......#......
....................
.##......#..........
................#...
......#...#.....#...
................#...
......#...#.....#...
....................
.###....#.......#...
................#...
.#..............#.#.
....................