....................
.##..###.....#......
.##..........#......
..@@@@.......#......
....................
.##......#..........
................#...
......#...#.....#...
..#.............#...
......#...#.....#...
....................
.###....#.......#...
................#...
.#......##......#.#.
....................